11,15
xxxxxxxxxxxxxxx
xs        x   x
xxxxxxxxx x x x
x x       x x x
x x xxxxxxx xxx
x x x   x     x
x x x x xxx x x
x x   x     x x
x xxxxxxxxxxx x
x            gx
xxxxxxxxxxxxxxx
